Östersund - Stockholm - Trondheim
Trondheim - Östersund
Málaga - Madrid
Rennes - Paris
Florence - Bologna - Rome - Venice
Holyhead - Birmingham - Dublin
Bristol - London
Wroclaw - Prague - Warsaw
Oslo - Stockholm - Bergen - Copenhagen
Riga - Vilnius - Tallinn
Penzance - London
Milan - Bern - Bologna - Munich - Nice - Venice
Barcelona - Montpellier - Madrid - Sevilla - Valencia
Sofia - Belgrade - Bucharest - Skopje - Thessaloniki - Istanbul
Lyon - Bern - Bordeaux - Marseille - Paris
Budapest - Krakau - Vienna - Bucharest - Ljubljana - Zagreb - Belgrade
Bordeaux - Lyon - Madrid - Paris
Vilnius - Bialystok - Klaipeda - Riga
Helsinki - Tallinn - Turku - Rovaniemi
Pamplona - Madrid
Split - Zagreb
Venice - Vienna - Ljubljana - Milan - Florence
Warsaw - Poznan - Wroclaw - Vienna - Krakow - Gdansk - Bialystok
Ankara - Istanbul
Istanbul - Ankara - Sofia
Ljubljana - Budapest - Zagreb - Venice
Madrid - Barcelona - Valencia - Málaga - Sevilla - Santiago de Compostela - Santander - Pamplona - Bordeaux
Paris - Bordeaux - Lyon - Frankfurt - Rennes - Brussels - London
Santiago de Compostela - Madrid
Montpellier - Barcelona - Marseille
Edinburgh - Birmingham - Aberdeen - Glasgow
Bergen - Oslo
Krakow - Warsaw
Gdansk - Warsaw
Westport - Dublin
Amsterdam - Berlin - Brussels - Cologne
Zagreb - Belgrade - Budapest - Ljubljana - Split
Berlin - Amsterdam - Cologne - Munich - Prague - Poznan - Hamburg
Bucharest - Belgrade - Budapest - Sofia
Dublin - Belfast - Cork - Holyhead - Westport
Krakau - Budapest
Brussels - Frankfurt - London - Cologne - Amsterdam - Paris
Vienna - Budapest - Munich - Prague - Venice - Warsaw
Lisboa - Faro - Porto
Athens - Thessaloniki - Patras
Munich - Berlin - Hamburg - Vienna - Frankfurt - Milan - Prague
Prague - Berlin - Munich - Vienna - Wroclaw
Thessaloniki - Athens - Skopje - Sofia
Copenhagen - Stockholm - Hamburg - Oslo
Rovaniemi - Helsinki
Birmingham - Edinburgh - Holyhead - London
London - Brussels - Penzance - Bristol - Birmingham - Paris
Patras - Athens - Bari
Skopje - Belgrade - Thessaloniki - Sofia
Turku - Helsinki
Bialystok - Vilnius - Warsaw
Frankfurt - Bern - Brussels - Cologne - Hamburg - Munich - Paris
Belfast - Dublin
Bari - Patras
Bologna - Milan - Florence
Stockholm - Copenhagen - Kiruna - Oslo - Östersund - Tallinn
Belgrade - Zagreb - Bucharest - Sofia - Skopje - Budapest
Aberdeen - Edinburgh
Cologne - Berlin - Brussels - Amsterdam - Frankfurt
Poznan - Berlin - Warsaw
Hamburg - Copenhagen - Berlin - Munich - Frankfurt
Kiruna - Stockholm
Bern - Milan - Rome - Frankfurt - Lyon
Klaipeda - Vilnius
Faro - Lisboa - Sevilla
Porto - Lisboa
Santander - Madrid
Sevilla - Barcelona - Madrid - Faro
Marseille - Lyon - Montpellier - Nice
Valencia - Barcelona - Madrid
Cork - Dublin
Glasgow - Edinburgh
Tallinn - Helsinki - Riga - Stockholm
Napoles - Rome - Catania
Rome - Bern - Napoles - Florence
Catania - Napoles
Nice - Milan - Marseille
